43 9 13
0 1 2 2 2 2 2 2 2 2 2 2 2 
3 4 2 2 2 2 2 2 2 2 2 2 2 
5 6 2 2 2 2 2 2 2 2 2 2 2 
7 8 2 2 2 2 2 2 2 2 2 2 2 
9 10 11 12 11 12 11 12 11 12 2 2 2 
13 14 15 16 15 16 15 16 15 16 2 2 2 
17 18 19 20 21 22 23 24 25 26 27 28 29 
30 31 32 33 34 35 36 37 38 39 40 41 42 
2 2 2 2 2 2 2 2 2 2 2 2 2 
