74 8 18
0 0 0 0 0 0 1 2 3 4 5 6 7 8 9 10 11 12 
0 0 0 0 0 0 13 14 15 16 17 18 19 20 0 21 22 23 
0 0 0 0 24 25 26 27 28 29 0 0 30 31 0 32 28 29 
0 0 0 0 33 34 13 35 36 37 0 0 38 39 40 41 36 37 
42 43 44 45 46 47 48 27 0 0 0 0 49 50 51 52 28 29 
53 54 55 56 57 58 59 35 0 0 0 0 60 39 40 61 36 37 
0 0 0 0 0 0 0 0 0 0 0 0 62 63 64 65 66 67 
0 0 0 0 0 0 0 0 0 0 0 0 68 69 70 71 72 73 
