82 11 21 128 128
0 0 0 0 0 0 0 0 1 2 3 4 1 2 0 0 0 0 0 0 0 
0 0 0 0 0 0 0 0 5 6 7 8 5 6 0 0 0 0 0 0 0 
0 0 0 0 0 0 9 10 11 12 13 14 15 16 17 18 19 20 0 0 0 
0 0 0 0 0 0 21 22 23 24 25 26 27 28 0 29 30 31 0 0 0 
0 0 0 0 32 33 34 35 1 2 0 0 36 37 0 38 1 2 0 0 0 
0 0 0 0 39 40 21 41 5 6 0 0 42 43 44 45 5 6 0 0 0 
46 47 48 49 50 51 52 35 0 0 0 0 53 54 55 56 1 2 0 0 0 
57 58 59 60 61 62 63 41 0 0 0 0 64 43 44 65 5 6 0 0 0 
0 0 0 0 0 0 0 0 0 0 0 0 66 67 68 69 70 71 72 73 0 
0 0 0 0 0 0 0 0 0 0 0 0 74 75 76 77 78 79 80 81 0 
0 0 0 0 0 0 0 0 0 0 0 0 0 0 0 0 0 0 0 0 0 
