23 6 11 256 256
0 0 0 0 1 2 1 0 0 0 0 
0 0 0 3 4 5 6 7 8 0 0 
0 0 9 10 1 0 11 12 1 0 0 
13 14 15 16 0 0 17 18 1 0 0 
0 0 0 0 0 0 19 20 21 22 0 
0 0 0 0 0 0 0 0 0 0 0 
