65 5 27
0 0 0 0 1 0 0 0 0 0 0 0 0 0 0 0 0 0 0 0 0 0 0 2 3 4 0 
0 0 0 0 5 6 7 8 9 10 11 12 13 7 8 14 0 0 0 0 0 0 0 15 16 17 0 
18 19 20 21 22 23 24 25 26 27 28 29 30 31 25 32 33 34 35 36 35 36 37 38 39 40 0 
41 42 43 44 45 46 47 48 49 50 51 52 53 54 55 56 57 58 59 60 59 60 61 62 63 64 0 
0 0 0 0 0 0 0 0 0 0 0 0 0 0 0 0 0 0 0 0 0 0 0 0 0 0 0 
