56 7 31 256 256 8 8
0 0 0 1 2 3 4 5 6 0 0 0 0 0 0 0 0 0 0 0 0 0 0 0 0 0 0 0 0 0 0 
0 0 7 8 9 0 10 11 9 12 0 13 0 0 0 0 0 0 0 0 0 0 0 0 0 0 0 0 0 0 0 
14 15 16 17 0 0 18 19 9 0 0 20 21 22 23 24 25 0 0 0 26 27 0 0 0 0 0 0 0 0 0 
0 0 0 0 0 0 28 29 30 31 32 33 34 35 36 37 38 39 40 40 41 42 43 44 0 0 0 0 0 0 0 
0 0 0 0 0 0 0 0 0 0 0 0 0 0 0 0 0 0 0 0 0 0 0 45 0 0 0 0 0 0 0 
0 0 0 0 0 0 0 0 0 0 0 0 0 0 0 0 0 0 0 0 0 0 0 46 47 47 47 47 0 0 0 
0 0 0 0 0 0 0 0 0 0 0 0 0 0 0 0 0 0 0 0 0 0 0 48 49 50 51 52 53 54 55 
