54 7 32 256 256
0 0 0 1 2 3 4 5 6 0 0 0 0 0 0 0 0 0 0 0 0 0 0 0 0 0 0 0 0 0 0 0 
0 0 7 8 9 0 10 11 9 0 0 0 0 0 0 0 0 0 0 0 0 0 0 0 0 0 0 0 0 0 0 0 
12 13 14 15 0 0 16 17 9 0 0 18 19 20 21 22 23 0 0 0 24 25 0 0 0 0 0 0 0 0 0 0 
0 0 0 0 0 0 26 27 28 29 30 31 32 33 34 35 36 37 38 38 39 40 41 42 0 0 0 0 0 0 0 0 
0 0 0 0 0 0 0 0 0 0 0 0 0 0 0 0 0 0 0 0 0 0 0 43 0 0 0 0 0 0 0 0 
0 0 0 0 0 0 0 0 0 0 0 0 0 0 0 0 0 0 0 0 0 0 0 44 45 45 45 45 0 0 0 0 
0 0 0 0 0 0 0 0 0 0 0 0 0 0 0 0 0 0 0 0 0 0 0 46 47 48 49 50 51 52 53 0 