152 20 27
0 0 0 0 0 0 0 0 0 0 0 0 0 0 0 0 0 0 0 1 2 3 4 5 6 7 8 
0 0 0 0 0 0 0 0 0 0 0 0 0 0 0 0 0 0 0 9 10 11 12 13 14 15 16 
0 0 0 0 0 0 0 0 0 0 0 0 0 0 0 0 0 0 0 17 18 19 20 21 22 23 24 
0 0 0 0 0 0 0 0 0 0 0 0 0 0 0 0 0 0 0 25 26 27 28 29 30 31 32 
0 0 0 0 0 0 0 0 0 0 0 0 0 0 0 0 0 0 0 33 34 35 36 37 38 38 38 
0 0 0 0 0 0 0 0 0 0 0 0 0 0 0 0 0 0 0 39 40 41 42 43 0 0 0 
0 0 0 0 0 0 0 0 0 0 0 0 0 0 0 0 0 0 0 39 44 45 46 47 0 0 0 
0 0 0 0 0 0 0 0 0 0 0 0 0 0 0 0 0 0 0 48 49 50 51 52 0 0 0 
0 0 0 0 0 0 0 0 0 0 0 0 0 0 0 0 0 0 0 53 54 55 56 57 0 0 0 
0 0 0 0 0 0 0 0 0 0 0 0 0 0 0 0 0 0 0 39 58 59 60 43 0 0 0 
0 0 0 0 0 0 0 0 0 0 0 0 0 0 0 0 0 0 0 61 62 27 63 47 0 0 0 
0 0 0 0 0 0 0 0 0 0 0 0 0 0 0 64 65 66 67 68 69 70 71 52 0 0 0 
0 0 0 0 0 0 0 0 0 0 0 0 0 0 0 72 73 74 75 76 77 78 79 57 0 0 0 
0 0 0 0 0 0 0 0 0 0 0 0 0 0 0 80 81 82 83 84 85 86 87 43 0 0 0 
0 0 0 0 0 0 0 0 0 0 0 0 0 0 0 88 89 90 91 92 93 94 95 47 0 0 0 
0 0 0 0 0 0 0 0 0 0 0 0 0 0 0 96 97 98 99 100 101 102 103 104 0 0 0 
105 0 0 0 0 0 0 0 0 0 0 0 0 0 0 106 107 108 109 110 111 112 38 113 0 0 0 
114 0 0 0 0 0 0 0 0 0 0 0 0 0 0 115 116 117 118 119 0 0 0 0 0 0 0 
120 121 122 121 122 121 123 124 125 126 127 128 129 130 131 132 133 134 135 136 0 0 0 0 0 0 0 
137 138 139 140 141 140 142 143 144 145 146 147 143 148 140 140 140 149 150 151 0 0 0 0 0 0 0 
