139 11 28
0 0 1 2 3 4 5 6 7 8 9 10 11 12 10 13 0 0 0 0 0 0 0 0 0 0 0 0 
14 15 0 16 17 18 19 20 21 22 22 23 24 25 23 26 0 0 0 0 0 0 0 0 0 0 0 0 
27 28 29 30 31 32 33 34 35 36 37 38 39 40 41 42 0 0 0 0 0 0 0 0 0 0 0 0 
43 43 43 44 45 46 47 48 49 50 51 52 53 54 55 56 57 58 58 59 58 58 60 58 58 59 58 61 
62 62 62 63 64 65 65 65 65 65 65 65 66 67 68 69 70 71 72 73 74 75 76 77 78 79 80 81 
0 0 0 0 0 0 0 0 0 0 0 0 82 83 84 85 86 87 0 88 89 90 91 92 93 0 94 95 
0 0 0 0 0 0 0 0 0 0 0 0 96 97 98 99 100 101 102 103 104 105 106 107 108 109 110 111 
0 0 0 0 0 0 0 0 0 0 0 0 112 113 114 115 113 116 117 118 119 120 121 122 123 124 125 126 
0 0 0 0 0 0 0 0 0 0 0 0 0 0 0 0 0 0 0 0 0 0 0 0 127 128 129 130 
0 0 0 0 0 0 0 0 0 0 0 0 0 0 0 0 0 0 0 0 0 0 0 0 131 132 133 134 
0 0 0 0 0 0 0 0 0 0 0 0 0 0 0 0 0 0 0 0 0 0 0 0 135 136 137 138 
