1 0 0 0 513 255 62 1
2 0 0 256 513 126 44 1
3 0 0 382 513 387 13 1
4 0 0 0 693 352 77 1
5 0 0 354 645 157 131 1
6 0 0 513 597 126 171 1
7 0 0 640 692 128 76 1
9 0 0 769 690 77 30 1
10 0 0 771 723 28 45 1
11 0 0 945 689 78 31 1
12 0 0 994 721 29 47 1
13 0 0 770 433 76 31 1
14 0 0 945 434 78 30 1
15 0 0 769 178 77 31 1
17 0 0 945 178 144 31 1
18 0 0 768 209 30 223 1
19 0 0 994 209 28 224 1
21 0 0 994 464 29 226 1
22 0 0 770 465 28 61 1
23 0 0 769 0 29 178 1
24 0 0 798 0 193 13 1
25 0 0 993 1 270 28 1
26 0 0 1265 0 45 62 1
27 0 0 1090 132 93 77 1
28 0 0 1185 164 62 90 1
30 0 0 1247 197 448 104 1
31 0 0 1393 0 221 94 1
32 0 0 1615 1 689 30 1
33 0 0 2001 257 48 365 1
34 0 0 1535 301 32 691 1
35 0 0 1568 946 64 77 1
36 0 0 1714 867 111 156 1
37 0 0 1827 900 60 123 1
38 0 0 2001 718 46 49 1
39 0 0 2017 768 62 50 1
40 0 0 2080 770 193 61 1
41 0 0 2273 769 46 126 1
42 0 0 1888 947 671 79 1
43 0 0 2561 946 611 78 1
44 0 0 2546 512 334 382 1
45 0 0 2320 767 226 14 1
48 0 0 1569 435 61 33 1
49 0 0 1568 692 64 34 1
51 0 0 1936 564 65 31 1
52 0 0 3072 722 34 225 1
53 0 0 3084 709 261 13 1
54 0 0 3097 698 235 10 1
55 0 0 3108 690 211 9 1
56 0 0 3127 682 175 8 1
57 0 0 3154 672 128 11 1
58 0 0 3327 722 35 46 1
59 0 0 3362 736 158 17 1
60 0 0 3520 722 290 47 1
61 0 0 3532 708 263 13 1
62 0 0 3546 697 235 11 1
63 0 0 3562 687 200 10 1
64 0 0 3581 679 163 9 1
65 0 0 3604 672 119 6 1
66 0 0 3810 737 30 15 1
69 0 0 3968 722 285 128 1
68 0 0 3935 736 33 15 1
70 0 0 3980 707 261 15 1
71 0 0 3996 694 227 14 1
72 0 0 4016 684 189 10 1
73 0 0 4037 672 144 13 1
75 0 0 3775 944 1616 80 1
76 0 0 3776 770 30 173 1
78 0 0 5392 767 253 126 1
79 0 0 5329 592 63 222 1
80 0 0 5872 768 46 127 1
81 0 0 5645 768 228 16 1
82 0 0 5919 768 225 31 1
83 0 0 5393 944 238 82 1
84 0 0 5631 948 352 78 1
85 0 0 5985 899 61 114 1
86 0 0 6113 800 31 351 1
87 0 0 5887 1027 33 29 1
88 0 0 5886 1057 17 382 1
89 0 0 5887 1440 31 350 1
90 0 0 6128 1153 29 270 1
91 0 0 5984 1716 474 77 1
92 0 0 6459 1721 16 70 1
93 0 0 6476 1726 17 67 1
94 0 0 6494 1730 16 63 1
96 0 0 6112 1537 128 47 1
97 0 0 6239 1535 254 63 1
98 0 0 6577 1537 124 61 1
99 0 0 6786 1538 124 60 1
100 0 0 6994 1535 141 64 1
101 0 0 7134 1536 66 48 1
102 0 0 7199 1536 194 31 1
103 0 0 7393 1536 301 126 1
104 0 0 6562 1730 17 61 1
105 0 0 6580 1722 20 69 1
106 0 0 6600 1716 73 77 1
107 0 0 6674 1723 20 70 1
108 0 0 6696 1732 91 59 1
110 0 0 6790 1723 22 69 1
111 0 0 6814 1717 68 75 1
112 0 0 6883 1721 20 71 1
113 0 0 6903 1725 16 68 1
114 0 0 6920 1732 61 60 1
115 0 0 6983 1727 18 64 1
116 0 0 7003 1721 17 69 1
118 0 0 7021 1716 907 76 1
119 0 0 7921 1550 9 168 1
120 0 0 7695 1536 234 15 1
137 1 0 5984 1507 176 29 1
136 1 0 5903 1411 158 29 1
134 1 0 5969 1316 126 26 1
135 1 0 5937 1220 126 27 1
132 1 0 5953 1124 159 26 1
131 1 0 1713 694 335 25 1
130 1 0 1569 565 318 26 1
129 1 0 1712 437 287 24 1
138 2 0 800 757 194 11 1
139 2 0 1632 1013 84 11 1
140 2 0 2003 176 13 81 1
141 2 0 2001 623 16 69 1
142 2 0 6127 1422 19 83 1
143 2 0 5917 1778 69 12 1
144 2 0 6511 1778 51 13 1
145 3 0 847 690 97 32 1
146 0 0 0 577 5 117 1
147 4 0 2301 896 7 51 1
148 4 0 2557 896 7 52 1
149 4 0 5630 894 5 54 1
150 4 0 5886 896 5 52 1
151 4 0 7678 1663 5 55 1
152 4 0 7421 1663 6 55 1
153 5 1 472 597 23 32 1
154 5 1 698 655 20 28 1
155 5 1 1882 382 26 44 1
156 5 1 1946 521 23 35 1
158 5 1 1952 650 21 36 1
159 5 1 1850 855 21 37 1
160 5 1 1586 386 27 42 0
161 5 1 1594 510 29 45 0
162 5 1 1588 651 24 34 0
164 6 1 951 378 22 49 1
165 6 1 953 638 23 42 1
166 6 1 818 382 20 44 0
167 7 1 3024 617 18 29 0
168 7 1 3261 584 22 35 1
169 7 1 3391 629 18 31 1
170 7 1 3512 625 20 32 1
171 7 1 3781 603 17 35 1
174 5 1 3192 624 25 40 1
175 5 1 3650 635 20 30 1
176 5 1 4101 636 17 29 1
177 7 1 4178 579 14 31 1
179 5 1 5973 1086 16 26 0
180 5 1 6050 1283 14 23 1
181 5 1 6068 1472 16 28 1
183 6 1 6102 1673 20 33 1
184 6 1 6378 1669 22 38 1
185 6 1 6628 1681 21 30 1
186 6 1 6834 1675 23 35 1
187 6 1 7026 1678 23 32 1
188 8 1 3392 707 95 28 1
189 8 1 6512 1536 48 240 1
190 8 1 6720 1536 47 195 1
191 8 1 6928 1536 47 193 1
192 9 1 3918 854 71 87 1
193 9 1 3843 712 91 40 1
194 8 1 4088 905 33 35 1
