0 0 0 2560 1280 4 0 
1 0 0 1280 640 0 0 
2 1280 0 2560 640 0 0 
3 0 640 1280 1280 4 0 
31 0 640 640 1600 0 1 73 
32 640 640 1280 1600 4 0 
321 640 640 1600 1760 4 0 
3211 640 640 1760 1840 4 0 
32111 640 640 1840 1880 4 0 
321111 640 640 1880 1900 4 0 
3211111 640 640 1900 1910 0 4 59 60 61 78 
3211112 1900 640 3160 1910 0 0 
3211113 640 1910 1900 3180 0 0 
3211114 1900 1910 3160 3180 0 0 
321112 1880 640 3120 1900 0 0 
321113 640 1900 1880 3160 0 0 
321114 1880 1900 3120 3160 0 0 
32112 1840 640 3040 1880 0 0 
32113 640 1880 1840 3120 0 0 
32114 1840 1880 3040 3120 0 0 
3212 1760 640 2880 1840 0 0 
3213 640 1840 1760 3040 0 0 
3214 1760 1840 2880 3040 0 0 
322 1600 640 2560 1760 0 0 
323 640 1760 1600 2880 0 0 
324 1600 1760 2560 2880 0 0 
33 0 1600 640 2560 0 0 
34 640 1600 1280 2560 0 0 
4 1280 640 2560 1280 4 0 
41 1280 640 3200 1600 4 0 
411 1280 640 3520 1760 4 0 
4111 1280 640 3680 1840 4 0 
41111 1280 640 3760 1880 4 0 
411111 1280 640 3800 1900 4 0 
4111111 1280 640 3820 1910 0 7 62 63 64 65 66 67 69 
4111112 3820 640 6360 1910 0 0 
4111113 1280 1910 3820 3180 0 0 
4111114 3820 1910 6360 3180 0 0 
411112 3800 640 6320 1900 0 0 
411113 1280 1900 3800 3160 0 0 
411114 3800 1900 6320 3160 0 0 
41112 3760 640 6240 1880 0 0 
41113 1280 1880 3760 3120 0 0 
41114 3760 1880 6240 3120 0 0 
4112 3680 640 6080 1840 0 0 
4113 1280 1840 3680 3040 0 0 
4114 3680 1840 6080 3040 0 0 
412 3520 640 5760 1760 0 0 
413 1280 1760 3520 2880 0 0 
414 3520 1760 5760 2880 0 0 
42 3200 640 5120 1600 0 0 
43 1280 1600 3200 2560 0 0 
44 3200 1600 5120 2560 0 0 
